"filename", "language", "CSS", "JavaScript", "comment", "blank", "total"
"f:\Work\BSE (Class 2021)\SEMESTER # 7\Final Year Project\travelholic\src\App.js", "JavaScript", 0, 35, 1, 5, 41
"f:\Work\BSE (Class 2021)\SEMESTER # 7\Final Year Project\travelholic\src\App.test.js", "JavaScript", 0, 7, 0, 2, 9
"f:\Work\BSE (Class 2021)\SEMESTER # 7\Final Year Project\travelholic\src\components\about\About.js", "JavaScript", 0, 13, 1, 3, 17
"f:\Work\BSE (Class 2021)\SEMESTER # 7\Final Year Project\travelholic\src\components\book-a-trip\Book-a-trip.js", "JavaScript", 0, 13, 1, 3, 17
"f:\Work\BSE (Class 2021)\SEMESTER # 7\Final Year Project\travelholic\src\components\destinations\Destinations.css", "CSS", 29, 0, 0, 3, 32
"f:\Work\BSE (Class 2021)\SEMESTER # 7\Final Year Project\travelholic\src\components\destinations\Destinations.js", "JavaScript", 0, 66, 2, 8, 76
"f:\Work\BSE (Class 2021)\SEMESTER # 7\Final Year Project\travelholic\src\components\destinations\destination-details\DestinationAttractions.js", "JavaScript", 0, 9, 0, 4, 13
"f:\Work\BSE (Class 2021)\SEMESTER # 7\Final Year Project\travelholic\src\components\destinations\destination-details\DestinationDetails.css", "CSS", 21, 0, 0, 3, 24
"f:\Work\BSE (Class 2021)\SEMESTER # 7\Final Year Project\travelholic\src\components\destinations\destination-details\DestinationDetails.js", "JavaScript", 0, 54, 6, 13, 73
"f:\Work\BSE (Class 2021)\SEMESTER # 7\Final Year Project\travelholic\src\components\destinations\destination-details\DestinationDetailsIntro.js", "JavaScript", 0, 33, 1, 3, 37
"f:\Work\BSE (Class 2021)\SEMESTER # 7\Final Year Project\travelholic\src\components\destinations\destination-details\DestinationGuidelines.js", "JavaScript", 0, 9, 0, 4, 13
"f:\Work\BSE (Class 2021)\SEMESTER # 7\Final Year Project\travelholic\src\components\destinations\destination-details\DestinationHistory.js", "JavaScript", 0, 9, 0, 4, 13
"f:\Work\BSE (Class 2021)\SEMESTER # 7\Final Year Project\travelholic\src\components\destinations\destination-details\DestinationPhotos.js", "JavaScript", 0, 9, 0, 4, 13
"f:\Work\BSE (Class 2021)\SEMESTER # 7\Final Year Project\travelholic\src\components\footer\Footer.css", "CSS", 34, 0, 0, 1, 35
"f:\Work\BSE (Class 2021)\SEMESTER # 7\Final Year Project\travelholic\src\components\footer\footer.js", "JavaScript", 0, 71, 0, 5, 76
"f:\Work\BSE (Class 2021)\SEMESTER # 7\Final Year Project\travelholic\src\components\forum\Forum.js", "JavaScript", 0, 13, 1, 4, 18
"f:\Work\BSE (Class 2021)\SEMESTER # 7\Final Year Project\travelholic\src\components\header\Navbar.css", "CSS", 22, 0, 0, 1, 23
"f:\Work\BSE (Class 2021)\SEMESTER # 7\Final Year Project\travelholic\src\components\header\Navbar.js", "JavaScript", 0, 59, 0, 3, 62
"f:\Work\BSE (Class 2021)\SEMESTER # 7\Final Year Project\travelholic\src\components\header\Searchbar.css", "CSS", 17, 0, 0, 3, 20
"f:\Work\BSE (Class 2021)\SEMESTER # 7\Final Year Project\travelholic\src\components\header\Searchbar.js", "JavaScript", 0, 16, 0, 7, 23
"f:\Work\BSE (Class 2021)\SEMESTER # 7\Final Year Project\travelholic\src\components\homepage\Slider.css", "CSS", 0, 0, 0, 1, 1
"f:\Work\BSE (Class 2021)\SEMESTER # 7\Final Year Project\travelholic\src\components\homepage\Slider.js", "JavaScript", 0, 37, 0, 4, 41
"f:\Work\BSE (Class 2021)\SEMESTER # 7\Final Year Project\travelholic\src\components\homepage\homepage.css", "CSS", 48, 0, 3, 3, 54
"f:\Work\BSE (Class 2021)\SEMESTER # 7\Final Year Project\travelholic\src\components\homepage\homepage.js", "JavaScript", 0, 95, 3, 12, 110
"f:\Work\BSE (Class 2021)\SEMESTER # 7\Final Year Project\travelholic\src\components\login\Login.js", "JavaScript", 0, 13, 1, 4, 18
"f:\Work\BSE (Class 2021)\SEMESTER # 7\Final Year Project\travelholic\src\components\plan-a-trip\Plan-a-trip.js", "JavaScript", 0, 13, 1, 3, 17
"f:\Work\BSE (Class 2021)\SEMESTER # 7\Final Year Project\travelholic\src\components\profile\Profile.js", "JavaScript", 0, 13, 1, 3, 17
"f:\Work\BSE (Class 2021)\SEMESTER # 7\Final Year Project\travelholic\src\components\sign-up\Sign-up.js", "JavaScript", 0, 13, 1, 4, 18
"f:\Work\BSE (Class 2021)\SEMESTER # 7\Final Year Project\travelholic\src\index.css", "CSS", 21, 0, 0, 2, 23
"f:\Work\BSE (Class 2021)\SEMESTER # 7\Final Year Project\travelholic\src\index.js", "JavaScript", 0, 12, 3, 3, 18
"f:\Work\BSE (Class 2021)\SEMESTER # 7\Final Year Project\travelholic\src\reportWebVitals.js", "JavaScript", 0, 12, 0, 2, 14
"f:\Work\BSE (Class 2021)\SEMESTER # 7\Final Year Project\travelholic\src\setupTests.js", "JavaScript", 0, 1, 4, 1, 6
"Total", "-", 192, 625, 30, 125, 972